24
24
230 231 230 231 230 231 230 231 230 231 230 231 230 231 230 231 230 231 230 231 230 231 230 231
232 233 232 233 232 233 232 233 232 233 232 233 232 233 232 233 232 233 232 233 232 233 232 233
228 229 2 2 2 2 2 2 2 2 15 16 2 2 2 2 2 2 2 2 2 2 228 229
230 231 2 2 2 2 2 2 2 2 15 16 2 2 2 2 2 2 2 2 2 2 230 231
232 233 2 2 2 2 2 2 2 2 15 16 2 2 2 2 2 2 2 2 2 2 232 233
228 229 2 2 2 2 2 2 2 2 15 16 2 2 2 2 2 2 2 2 2 2 228 229
230 231 2 2 2 2 2 2 2 2 15 16 2 2 2 2 2 2 2 2 2 2 230 231
232 233 2 2 2 2 2 2 2 2 15 16 2 2 2 2 2 2 2 2 2 2 232 233
228 229 2 2 2 2 2 2 2 2 15 16 2 2 2 2 2 2 2 2 2 2 228 229
230 231 2 2 2 2 2 2 2 2 15 16 2 2 2 2 2 2 2 2 2 2 230 231
232 233 2 2 2 2 2 2 2 2 15 16 2 2 2 2 2 2 2 2 2 2 232 233
228 229 1 1 1 1 1 1 1 1 15 16 2 2 2 2 2 2 2 2 2 2 228 229
230 231 1 1 1 1 1 1 1 1 15 16 2 2 2 197 198 199 200 201 2 2 230 231
232 233 1 1 1 1 1 1 1 1 15 16 2 2 2 202 203 204 205 206 2 2 232 233
228 229 1 1 1 1 1 1 1 1 15 16 2 2 2 207 208 209 210 211 2 2 228 229
230 231 1 1 1 1 1 1 1 1 15 16 2 2 2 212 213 214 215 216 2 2 230 231
232 233 1 1 1 1 1 1 1 1 15 16 2 2 2 217 218 219 220 221 2 2 232 233
228 229 1 1 1 1 1 1 1 1 15 21 18 18 18 18 18 18 18 18 12 2 228 229
230 231 2 2 2 2 2 2 2 2 15 19 17 17 17 17 17 17 17 20 16 2 230 231
232 233 2 2 2 8 7 7 9 2 15 16 222 222 222 222 222 222 223 15 16 2 232 233
228 229 2 2 2 5 4 4 6 2 15 16 2 2 2 2 2 2 2 15 16 2 228 229
230 231 2 2 2 5 4 4 6 2 15 21 18 18 18 18 18 18 18 22 16 2 230 231
232 233 2 2 2 10 10 10 10 2 13 17 17 17 17 17 17 17 17 17 14 2 232 233
228 229 228 229 228 229 228 229 228 229 228 229 228 229 228 229 228 229 228 229 228 229 228 229