24
24
20 20 20 20 20 20 20 20 20 20 20 20 20 20 20 20 20 20 20 20 20 20 20 20
20 20 20 20 20 20 20 20 20 20 20 20 20 20 20 20 20 20 20 20 20 20 20 20
20 20 2 1 1 1 1 1 1 1 1 1 1 1 1 1 1 1 1 1 1 2 20 20
20 20 2 1 1 1 1 1 1 1 1 1 1 1 1 1 1 1 1 1 1 2 20 20
20 20 2 1 1 1 1 1 1 1 1 1 1 1 1 1 1 1 1 1 1 2 20 20
20 20 2 1 1 1 1 1 1 1 1 1 1 1 1 1 1 1 1 1 1 2 20 20
20 20 2 1 1 1 1 1 1 1 1 1 1 1 1 1 1 1 1 1 1 2 20 20
20 20 2 1 1 1 1 1 1 1 1 1 1 1 1 1 1 1 1 1 1 2 20 20
20 20 2 1 1 1 1 1 1 1 1 1 1 1 1 1 1 1 1 1 1 2 20 20
20 20 2 1 1 1 1 1 1 1 1 1 1 1 1 1 1 1 1 1 1 2 20 20
20 20 2 1 1 1 1 1 1 1 1 1 1 1 1 1 1 1 1 1 1 2 20 20
20 20 2 1 1 1 1 1 1 1 1 1 1 1 1 1 1 1 1 1 1 2 20 20
20 20 2 1 1 1 1 1 1 1 1 1 1 1 1 1 1 1 1 1 1 2 20 20
20 20 2 1 1 1 1 1 1 1 1 1 1 1 1 1 1 1 1 1 1 2 20 20
20 20 2 1 1 1 1 1 1 1 1 1 1 1 1 1 1 1 1 1 1 2 20 20
20 20 2 1 1 1 1 1 1 1 1 1 1 1 1 1 1 1 1 1 1 2 20 20
20 20 2 1 1 1 1 1 1 1 1 1 1 1 1 1 1 1 1 1 1 2 20 20
20 20 2 1 1 1 1 1 1 1 2 2 2 2 2 2 2 2 2 2 2 3 20 20
20 20 2 1 1 1 1 1 1 1 2 2 2 2 2 2 2 2 2 2 2 3 20 20
20 20 2 2 2 22 22 22 2 2 3 3 3 3 3 3 3 3 3 2 2 3 20 20
20 20 2 2 2 22 22 22 2 2 3 3 3 3 3 3 3 3 3 2 2 3 20 20
20 20 2 2 2 22 22 22 2 2 2 2 2 2 2 2 2 2 2 2 2 3 20 20
20 20 20 20 20 20 20 20 20 20 20 20 20 20 20 20 20 20 20 20 20 20 20 20
20 20 20 20 20 20 20 20 20 20 20 20 20 20 20 20 20 20 20 20 20 20 20 20